########################
##--------------------##
#|####################|#
#|##----------------##|#
#|#|################|#|#
#|#|##------------##|#|#
#|#|#|############|#|#|#
#|#|#|##--------##|#|#|#
#|#|#|#|########|#|#|#|#
#|#|#|#|########|#|#|#|#
#|#|#|#|########|#|#|#|#
#|#|#|#|########|#|#|#|#
#|#|#|#|########|#|#|#|#
#|#|#|#|########|#|#|#|#
#|#|#|#|########|#|#|#|#
#|#|#|#|########|#|#|#|#
#|#|#|##--------##|#|#|#
#|#|#|############|#|#|#
#|#|##------------##|#|#
#|#|################|#|#
#|##----------------##|#
#|####################|#
##--------------------##
########################