################################
##----------------------------##
#|############################|#
#|############################|#
#|############################|#
#|############################|#
#|############################|#
#|############################|#
#|############################|#
#|############################|#
#|############################|#
#|############################|#
#|############################|#
#|############################|#
#|############################|#
#|############################|#
#|############################|#
#|############################|#
#|############################|#
#|############################|#
#|############################|#
#|############################|#
#|############################|#
#|############################|#
#|############################|#
#|############################|#
#|############################|#
#|############################|#
#|############################|#
#|############################|#
##----------------------------##
################################