################################
##----------------------------##
#|############################|#
#|##------------------------##|#
#|#|########################|#|#
#|#|##--------------------##|#|#
#|#|#|####################|#|#|#
#|#|#|##----------------##|#|#|#
#|#|#|#|################|#|#|#|#
#|#|#|#|##------------##|#|#|#|#
#|#|#|#|#|############|#|#|#|#|#
#|#|#|#|#|##--------##|#|#|#|#|#
#|#|#|#|#|#|########|#|#|#|#|#|#
#|#|#|#|#|#|##----##|#|#|#|#|#|#
#|#|#|#|#|#|#|####|#|#|#|#|#|#|#
#|#|#|#|#|#|#|####|#|#|#|#|#|#|#
#|#|#|#|#|#|#|####|#|#|#|#|#|#|#
#|#|#|#|#|#|#|####|#|#|#|#|#|#|#
#|#|#|#|#|#|##----##|#|#|#|#|#|#
#|#|#|#|#|#|########|#|#|#|#|#|#
#|#|#|#|#|##--------##|#|#|#|#|#
#|#|#|#|#|############|#|#|#|#|#
#|#|#|#|##------------##|#|#|#|#
#|#|#|#|################|#|#|#|#
#|#|#|##----------------##|#|#|#
#|#|#|####################|#|#|#
#|#|##--------------------##|#|#
#|#|########################|#|#
#|##------------------------##|#
#|############################|#
##----------------------------##
################################