################################
################################
################################
################################
################################
################################
################################
################################
################################
################################
################################
################################
################################
################################
################################
################################
################################
################################
################################
################################
################################
################################
################################
################################
################################
################################
################################
##----------------------------##
#|############################|#
#|##------------|#|---------##|#
#|##############|#|#########|#|#
################################