################
##------------##
#|############|#
#|##--------##|#
#|#|########|#|#
#|#|##----##|#|#
#|#|#|####|#|#|#
#|#|#|####|#|#|#
#|#|#|####|#|#|#
#|#|#|####|#|#|#
#|#|##----##|#|#
#|#|########|#|#
#|##--------##|#
#|############|#
##------------##
################